11111111111111111111111111111111111
10000C00000000000000000000000000001
1000111110C000100000000100011111001
10001000000001010000001100000001001
10001000000010001C0001010C000001001
10001111000011111000100100011111001
10001E00000010001001000100010000001
10001000000010001001111110010000001
10001111100010001000000100011111C01
1P000000000000000000000000000000001
11111111111111111111111111111111111